NO textures/brick.png
SO textures/redbrick.png
WE textures/graywallshade1.png
EA textures/graywallshade2.png

F 203,166,247
C 4,165,229

11111
1e001
10001
10001
10001
10001
10001
10001
10001
10001
10N01
11111