NO textures/brick.png
SO textures/redbrick.png
WE textures/graywallshade1.png
EA textures/graywallshade2.png

F 203,166,247
C 4,165,229

11111
1e1S1
10101
10001
11111