NO textures/brick1.png
SO textures/brick2.png
WE textures/brick3.png
EA textures/brick4.png
DO textures/door3.png

F 20,18,16
C 04,02,73

        1111111111111111111111111
        1000000000110000000000001
        1011000001110000000000001
        1001000000000000000000001
111111111011000001110000000000001
100000000011000001110111111111111
1111011111111101110000000e0e1
11110111111111011101010010001
11000000110101011100000010001
1000000000000000110000001DDD1
10000000000000001101010010001
11000001110101011111011110N0111
11110111 1110101 101111010001
11111111 1111111 111111111111