NO ./wolftex/greystone.png
WE ./wolftex/wood.png
F 122,0,255
EA ./wolftex/wood.png
SO ./wolftex/redbrick.png
C 42,0,81

                                         11111
1       1                  111          11000111111111
11111111111111111          101          11000000000001
100000000000000011111111111111111111111111000000000001
100000000000000000000000000000000000000000000000000001
100000N00000000011111110111111111111111111110111111111
10000000000000001     101                  101
1000000000000000111111101111111111111111111101
1000000000000000000000000000000000000000000001
1000000000000000111111111111111111111111111111
11111111111111111
