WE                                                                                                                   ./wolftex/wood.png

SO                                                                         ./wolftex/redbrick.png
F                                  122                    ,                       122,                    122
NO                                                                             ./wolftex/greystone.png
EA                                                                                           ./wolftex/wood.png

C                                           255                                                                                            ,200,160
11111111111111111
10000000000000001
10000000000000001
10000000000000001
10000000000000001
10000000000000001
10000000N00000001
10000000000000001
10000000000000001
10000000000000001
10000000000000001
10000000000000001
11111111111111111
