R 1080 720
NO ./wolftex/greystone.png
SO ./wolftex/redbrick.png
EA ./wolftex/wood.png
WE ./wolftex/wood.png
S ./wolftex/barrel.png
C 255,200,160
F 122,122,122

                                         11111
                                        11000111111111
11111111111111111                       11000000000001
100000000000000011111111111111111111111111000000000001
100000000000000000000000000000000000000000000000000001
100000000000000011111111111111111111111111111111011111
10000000000000001                              101
10000000000000001                              101111111111111111
10000000N00000001                              100000000000000001
10000000000000001                              111111111111111101
10000000000000001                                             101
10000000000000001                                             101
10000000000000001                                             101
10000000000000001                                             101
11111011111111111                                             101
    101                                                       101
11111011111111111                                             101
10000000000000001                                             101
10000000000000001                                             101
10000000000000001111111111111111111111111111111111111111111111101
10000000000000000000000000000000000000000000000000000000000000001
10000000000000001111111111111111111111111111111111111111111111111
10000000000000001
10000000000000001
10000000000000001
10000000000000001
10000000000000001
10000000000000001
11111111111111111
