NO textures/wall_debug/north.png
SO textures/wall_debug/south.png
WE textures/wall_debug/west.png
EA textures/wall_debug/east.png

F 150,150,150
C 100,100,100

11111
10001
10S01
10001
11111