NO textures/brick.png
SO textures/brick.png
WE textures/brick.png
EA textures/brick.png

F 203,166,247
C 4,165,229

1111
1001
1N01
1111
