NO textures/brick1.png
SO textures/brick2.png
WE textures/brick3.png
EA textures/brick4.png
DO textures/door3.png

F 00,255,00
C 00,00,255

        1111111111111111111111111
        1000000000110000000000001
        1011000001110000000000001
        1001000000000000000000001
111111111011000001110000000000001
100000000011000001110111111111111
1111011111111101110e00000e0e1
11110111111111011101010010001
11000000110101011100000010001
1000000000000000110000001DDD1
10000000000000001101010010S01
1100000111010101111101111000111
11110111 1110101 10111101ahx1
11111111 1111111 111111111111