NO textures/wolf_cobble_wall.png
SO textures/wolf_cobble_wall1.png
WE textures/wolf_moss_wall0.png
EA textures/wolf_moss_wall1.png
DO textures/door/wolf_door.png

F 255,0,0
C 04,02,73


11111111111111111111111111111111111111111111111111111111
11111111111000e00000000000D0x111111DDDDDD000e00011111111
11111101111011111110111111111111111D00e00D1111101111x111
111110001110111111100D0D0D00D001111D01010011111e00000001
111111011110h1111111011111101101111D00e00D11111011111101
1111x000111000e000000a11111011011h1D01010011111011111a01
11e101D1e101D1111011e000D0001100000000e00D0000000000D001
10000000000001111011D11111101101111111111111110111110111
1010101e1011011110110001111010a111111111111111e111110111
11111D1111110a1110110N000D000000000011111D11110111110111
11111011111100011011000111101011011011111011110111110111
111110111111011110111D11111010110110D000e00D0000000D0001
11111011111101111000D0D0111e1011000011111011101111101111
11111e000001011111111D1111101011111111111D11101111101111
11111111D111011111111011111011111111111110111e1111101111
111111D0000000000000001110000011111111111011101111101111
111111111111111111111h111111a1111111111110111011h1101111
111110111111011110111D11111010110110D000000D000000D00001
11111011111101111e00D0D0111e10110000h1111011111111011111
1111100e0001011111111D1111101011111111111D11111111011111
11111111D11101111111101111101111111111111a11111111011111
1111x0D0000000e0000000DhD00000e0000000000000D000000x1111
11111111111111111111111111111111111111111111111111111111