     11111     
111111000111111
100000000000001
100000000000001
110000000000111
100000000000001
111111000111111
     11111
