NO textures/wolf_cobble_wall.png
SO textures/wolf_cobble_wall1.png
WE textures/wolf_moss_wall0.png
EA textures/wolf_moss_wall1.png
DO textures/door/wolf_door.png

F 255,0,0
C 04,02,73

11111
10001
10e01
10001
11D11
10001
10e01
10001
11D11
10001
10e01
10001
11D11
10001
10e01
10001
11D11
10001
10e01
10001
11D11
10001
10e01
10001
11D11
10001
10e01
10001
11D11
10001
10e01
10001
11D11
10001
10e01
10001
11D11
10001
10e01
10001
11D11
10001
10e01
10001
11D11
10001
10e01
10001
11D11
10001
10e01
10001
11D11
10001
10e01
10001
11D11
10001
10e01
10001
11D11
10001
10e01
10001
11D11
10001
10e01
10001
11D11
10001
10e01
10001
11D11
10001
10e01
10001
11D11
10001
10e01
10001
11D11
10001
10e01
10001
11D11
10001
10N01
10001
11111
