1111111111
1000100001
1001000001
1000000001
1000000001
1000N00001
1000000001
1000000001
111111111
