NO ./path_to_the_texture
SO ./path_to_the_texture
WE ./path_to_the_texture
EA ./path_to_the_texture

F 203,166,247
C 4,165,229

1111111111
1000000001
1001111001
1000000001
1000W00001
1000000001
1000000001
111111111
