1111111111
1N00000001
1001111001
1000000001
1000N00001
1000000001
1000000001
111111111
