1111111111
1000000001
1001000001
1000000001
1000000001
1000N00001
1000001111
1000000001
1111111111
