NO textures/north.png
SO textures/south.png
WE textures/west.png
EA textures/east.png

F 240,166,247
C 4,165,229

1111111111
1000000001
1001111001
1000110001
1000N00001
1010101011
1000000001
1111111111
