NO textures/wolf_cobble_wall.png
SO textures/wolf_cobble_wall1.png
WE textures/wolf_moss_wall0.png
EA textures/wolf_moss_wall1.png
DO textures/door/wolf_door.png

F 255,0,0
C 04,02,73

111111111111111111111111111111111
1110D010e000000000110e00000001ah1
111010101011000001110000000e01001
111x100e100100000000000000000D001
111d1111101100000111000e000001001
1000000000110000011101111111111d1
1111011111111101110000000000111d1
11110111111111011101010010e0111d1
1100000011010101110000001000111d1
1000000e000000001100000011D1111d1
100e0000000000001101010010x00ddd1
1h00000h110101011111011110N011111
111aaa11111101011101111ad00011111
111111111111111111111111111111111
