WE ./wolftex/greystone.png
SO ./wolftex/redbrick.png
EA ./wolftex/wood.png
NO ./wolftex/wood.png
C 255,200,160
F 122,122,122
DO 

11111111111111111
10000000000000001
100D0000000000001
10000000000000001
10000000000000001
10000000000000001
10000000N00000001
10000000000000001
10000000000000001
10000000000000001
10000000000000001
10000000000000001
11111111111111111
