NO ./wolftex/greystone.png
SO ./wolftex/redbrick.png
EA ./wolftex/wood.png
WE ./wolftex/wood.png

C 255,200,160
F 122,122,122

11111111111111111
10000000000000001
10000000000000001
10000000000000001
10000000000000001
10000000000000001   11D
10000000000000001   1N1
10000000000000001   111
10000000000000001
10000000000000001
10000000000000001
10000000000000001
11111111111111111
